R 800 600
NO pics/redbrick.xpm
SO pics/eagle.xpm
WE pics/bluestone.xpm
EA pics/purplestone.xpm

S pics/barrel.xpm
F 255,0,127
C 0,255,255

        1111111111111111111111111
        10000000001100222000000W1
        1011000001110022200000001
        1001000000000000000000001
111111111011020001110000200000001
100000000011000021110111111111111
11110111111111010000000010001
11110111111111011101010010001
11000000110101011100020010201
10002000200000001100000000201
10002000002002001101010010201
1100000111010101111101111020111
11110111 1110101 101111010001
11111111 1111111 111111111111
