R 1920 1080
NO ./path_to_the_north_texture
SO ./path_to_the_south_texture
WE ./path_to_the_west_texture
EA ./path_to_the_east_texture

S ./path_to_the_sprite_texture
F 220,100,0
C 225,30,0

    11111111111111111
    12222222222222221
    12222222222222221
111112222222222222221
122222222222222222211
12222211111222222w221
122222222222222222211
122222222122222222221
111122221111111111111
    1111
